##.##.#
#..##.#
#.###.#
#..##.#
##.##.#